111111111111111111111
100000000000000000001
101110110111011011101
101000010000010000101
101011011101110110101
100011000000000110001
101000010101010000101
101110110101011011101
100000010000010000001
101111010101010111101
100000000101000000001
101111010111010111101
100000010000010000001
101110110101011011101
101000010101010000101
100011000000000110001
101011011101110110101
101000010000010000101
101110110111011011101
100000000000000000001
111111111111111111111

00001 - 1 g1
00010 - 2 g2
00100 - 4 g3
01000 - 8 g4?
10000 - 16 player?