111111111111111111111
100000000000000000001
101110110111011011101
101000010000010000101
101011011101110110101
100011000000000110001
101000010101010000101
101110110101011011101
100000000000000000001
101111101101101111101
100000001000100000001
101111101111101111101
100000000000000000001
101110110101011011101
101000010101010000101
100011000000000110001
101011011101110110101
101000010000010000101
101110110111011011101
100000000000000000001
111111111111111111111